111111111111111111111
1P00000C00100000C0001
111101111011111110111
100001000010001000001
111101111011101111101
100000000C00000000001
111101111111101111101
100C000100000001E0001
111111111111111111111
