111111111111111111111111111111111111111
1P0010000000C000100010000000C0001000001
111001111011101110111111111110111011101
100001000000001000000000000000000001000
111101111011111111101111011101111101111
100000C000000000000C00000000000000000E1
111101111011111011101110111011101111101
100000000000001000001000000000000000001
111101111011101110111111111111101111111
100C00010001000000000000100010000000001
111111111111111111111111111111111111111
