111111111111111111111
1P0000000C000000000E1
111111111111111111111
